8
20
||||||||||||||||||||
|O..............O..|
|.@..|||||||...F...|
|....|O....|.......|
|....|.............|
|.O..|||||||....O..|
|....F..O..........|
||||||||||||||||||||