5
10
||||||||||
|FO|.O.|O|
|..|..@..|
|..O.....|
||||||||||