9
25
|||||||||||||||||||||||||
|.O|...O.........O...|O.|
|.F|.................|F.|
||...|||||||||||||||...||
||.........@...........||
||...|||||||||||||||...||
|F.|.................|..|
|O.|...O.........O...|.O|
|||||||||||||||||||||||||